#-####
#---##
--#--#
#----#
#-#--#
###-##
